version=1
14
22
3
xxxxxxxxxxxxxxxxxxxxxx
xsx-x-x-x-x-x-x-x-xrxx
x--------------------x
xx-x-x-x-x-x-x-x-x-x-x
x--------------------x
x-x-x-x-x-x-x-x-x-x-xx
x--------------------x
xx-x-x-x-x-x-x-x-x-x-x
x--------------------x
x-x-x-x-x-x-x-x-x-x-xx
x--------------------x
xx-x-x-x-x-x-x-x-x-x-x
xr-----------------xex
xxxxxxxxxxxxxxxxxxxxxx