version=1
28
46
3
xxxxxxxxxxxxxxxxxxxxxxxxxxxxxxxxxxxxxxxxxxxxx
xsx-x-x-x-x-x-x-x-x-x-x-x-x-x-x-x-x-x-x-x-x-x
x-------------------------------r-----------x
xx-x-x-x-x-x-x-x-x-x-x-x-x-x-x-x-x-x-x-x-x-xx
x-------------------------------------------x
x-x-x-x-x-x-x-x-x-x-x-x-x-x-x-x-x-x-x-x-x-x-x
x-------------------------------------------x
xx-x-x-x-x-x-x-x-x-x-x-x-x-x-x-x-x-x-x-x-x-xx
x-------------------------------------------x
x-x-x-x-x-x-x-x-x-x-x-x-x-x-x-x-x-x-x-x-x-x-x
x-------------------------------------------x
xx-x-x-x-x-x-x-x-x-x-x-x-x-x-x-x-x-x-x-x-x-xx
x-------------------------------------------x
x-x-x-x-x-x-x-x-x-x-x-x-x-x-x-x-x-x-x-x-x-x-x
x-------------------------------------------x
xx-x-x-xrx-x-x-x-x-x-x-x-x-x-x-x-x-x-x-x-x-xx
x-------------------------------------------x
x-x-x-x-x-x-x-x-x-x-x-x-x-x-x-x-x-x-x-x-x-x-x
x-------------------------------------------x
xx-x-x-x-x-x-x-x-x-x-x-x-x-x-x-x-x-x-x-x-x-xx
x-------------------------------------------x
x-x-x-x-x-x-x-x-x-x-x-x-x-x-x-x-x-x-x-x-x-x-x
x-------------------------------------------x
xx-x-x-x-x-x-x-x-x-x-x-x-x-x-x-x-x-x-x-x-x-xx
x-------------------------------------------x
x-x-x-x-x-x-x-x-x-x-x-x-x-x-x-x-x-x-x-x-x-x-x
x-------------------------------r---------xex
xxxxxxxxxxxxxxxxxxxxxxxxxxxxxxxxxxxxxxxxxxxxx