version=1
8
12
3
xxxxxxxxxxxx
x--x----x-sx
xx--x-x-xx-x
x----xs----x
xx-x--x-x-xx
x-rx----x--x
xe---x-xx-sx
xxxxxxxxxxxx