version=1
8
12
xxxxxxxxxxxx
xx-s---x---x
xsx-xxxx-x-x
x-x--x---x-x
x---s--x-xex
xx-x-x--x-xx
xs-x--x----x
xxxxxxxxxxxx