version=1
8
12
xxxxxxxxxxxx
x-x--x--x-xx
xs-----x---x
xx-s-xxe-x-x
xx-xx--x-x-x
x----x-x---x
xsx-------xx
xxxxxxxxxxxx