version=1
8
12
3
xxxxxxxxxxxx
xs--x--x-x-x
xx-xsx-----x
x----xxx-x-x
x-xx--x---xx
xs--x---x--x
xx-x--x-rxex
xxxxxxxxxxxx