version=1
8
12
3
xxxxxxxxxxxx
xsx-x---rxsx
x-x---xx---x
x---xe--x-xx
xx---xx-x--x
xx-x-----x-x
xs--x-x---sx
xxxxxxxxxxxx