version=1
14
22
3
xxxxxxxxxxxxxxxxxxxxxx
xs----------xxx------x
x-x-xx-xx-x-----x--x-x
xxx--x-x-xx-x--xx--x-x
x---x-x---x-x-xxx-x--x
x-xxx---x--x-xs---xx-x
x-x-x-xx-x-x-xxxxxxxxx
x------x-------xx----x
x-x-x-xx-x-x-xxxx-xx-x
x-----sx-------xx--x-x
x-x-x-xx-x-x-xxxxx-x-x
x------x-------xx--x-x
xsx-x-x-x-xx-x----rxex
xxxxxxxxxxxxxxxxxxxxxx