version=1
8
12
3
xxxxxxxxxxxx
xe-xx-x---xx
xx----xxx--x
x-r-x-x---xx
x-x--------x
x----x-x-x-x
x-xxx---x-sx
xxxxxxxxxxxx