version=1
8
12
3
xxxxxxxxxxxx
xsx-x-x-x-xx
x---r------x
xx-x-x-x-x-x
x----r----?x
x-x-x-x-x-xx
xr-r------ex
xxxxxxxxxxxx