version=1
8
12
3
xxxxxxxxxxxx
xexs---x-x-x
x--x-x-xx-xx
xx--x--x---x
x--x-x---x-x
x-x---xrx--x
x---x-----xx
xxxxxxxxxxxx