version=1
8
12
xxxxxxxxxxxx
xsx---x---xx
x-x-x-x-x-xx
x-x-x-x-x-xx
x-x-x-x-x-xx
x-x-x-x-x-xx
x---x---x-ex
xxxxxxxxxxxx