version=1
8
12
3
xxxxxxxxxxxx
xsx---x---xx
x-x-x-x-x-xx
x-x-x-x-x-xx
x-x-x-x-x-xx
x-x-x-x-x-rx
x---x---x-ex
xxxxxxxxxxxx