version=1
14
22
3
xxxxxxxxxxxxxxxxxxxxxx
x-x-x-x-x-x-x-x-x-x-xx
xx-x-x-x-x-x-x-x-x-x-x
x-x-x-x-x-x-x-x-x-x-xx
xx-x-x-x-x-x-x-x-x-x-x
xxxxxxxxxxrxxxxxxxxxxx
xs------------------ex
xxxxxxxxxxxxxxxxxxxxxx
xx-x-x-x-x-x-x-x-x-x-x
x-x-x-x-x-x-x-x-x-x-xx
xx-x-x-x-x-x-x-x-x-x-x
x-x-x-x-x-x-x-x-x-x-xx
xx-x-x-x-x-x-x-x-x-x-x
xxxxxxxxxxxxxxxxxxxxxx