version=1
14
22
3
xxxxxxxxxxxxxxxxxxxxxx
xs-x-x-x--x--xxx?-xxex
x-x----x-x--x---x----x
x--x-x----x-x-x---x-rx
xx-----x--------x---?x
x-x-x--xx--x-xx---xxxx
x----x-x--x--x--x---xx
xxx------x--xx-xx-x--x
x---x-xx---x-------x-x
x---x-xx---x-------x-x
xx-------x---x-x-x---x
x--x-x----x--x--x--xxx
x-x---x-x--x-xx--xx--x
xs--x----x-x---x----sx
xxxxxxxxxxxxxxxxxxxxxx