version=1
14
22
3
xxxxxxxxxxxxxxxxxxxxxx
x-----x------x---xs-xx
x-x-x---xx-x---x--x--x
xx-x--------x---x---xx
xx---x-xx-x---x-x--x-x
xx-x-x---x--x-xs-x---x
x----x--x-----x---x--x
xx-x?x-xx-x-x--x-x--xx
x---x------x---x--x--x
x?x---x-x----x--x--x-x
xx-x-x--x-xx--x---xs-x
x-x---x---x-x-xxr--xxx
xe--x---x------------x
xxxxxxxxxxxxxxxxxxxxxx