version=1
14
22
xxxxxxxxxxxxxxxxxxxxxx
x--x-sx--x---x---xs-xx
xx-x-x--xxx-x--x---x-x
xs----x-----xx-xxx---x
x-x-x---x-x-x-------xx
xx---x-x-x----x--x-xxx
x-----------x---xxx-xx
x-xxx--x--x-x-x------x
x--x--x--xx-x--x--xx-x
xxs----x-----------x-x
xxx-xx---x--x--x----xx
xx---xx-xxx-x-xxx-x--x
x--x-x------x------xex
xxxxxxxxxxxxxxxxxxxxxx