version=1
14
22
xxxxxxxxxxxxxxxxxxxxxx
xs-x-x--x--xx-x--x-x?x
xx---x---x-----x---x-x
x-x-x---x--x--xx-x---x
x---x----x--x-x---x-xx
xx----x----xx---x--x?x
xsxx-xxx-xx-x--xx--x-x
x-------x-----x---xx-x
xx--x-x-x-xx-x--x----x
x--xx---x--x---xxx-x-x
xx-x--x------x--x--xxx
xx---x-x-x-x--x--x---x
xs-x-x----x---x----xex
xxxxxxxxxxxxxxxxxxxxxx