version=1
14
22
3
xxxxxxxxxxxxxxxxxxxxxx
xs-x--xsx-x-xxs-x-x-sx
xx-x-x--xx----x-x---xx
xx-x---x--x--x---x-x-x
xx--x---x--x---x-----x
x-x-x-x---x--x---x-xxx
x--------x--x--xx--x-x
xx-x-xxx---x--xx-x---x
x--------x----------xx
xx-x-xx-x-x-x--x-xx--x
x-x-------------x----x
x---x--r-x-x-x----xx-x
xx----x-e---?-x-xx---x
xxxxxxxxxxxxxxxxxxxxxx