version=1
14
22
3
xxxxxxxxxxxxxxxxxxxxxx
xsx--x-x--x-x--x-x--xx
x-x--x-x--x-x--x-x--xx
x-xxxx-xxxx-xxxx-xxxxx
x-------------------ex
x-xxxx-xxxx-xxxx-xxxxx
x-x--x-x--x-x--x-x--xx
x-x--x-x--x-x--x-x--xx
x-xxxx-xxxx-xxxx-xxxxx
x-------------------?x
x-xxxx-xxxx-xxxx-rxxxx
x-x--x-x--x-x--x-x--xx
x-x--x-x--x-x--x-x--xx
xxxxxxxxxxxxxxxxxxxxxx