version=1
62
102
xxxxxxxxxxxxxxxxxxxxxxxxxxxxxxxxxxxxxxxxxxxxxxxxxxxxxxxxxxxxxxxxxxxxxxxxxxxxxxxxxxxxxxxxxxxxxxxxxxxxxx
xs----------xxxxx----------x-xx-xx-x-------x-xx-xx--x-xx-xx-x-------x-xx-xx--x-xx-xx-x-------x-xxsxx-x
x-x-xx-xx-x-------x-xx-xx--x-xx-xx-x-------x-xx-xx--x-xx-xx-x-------x-xx-xx--x-xx-xx-x-------x-xx-xx-x
xxx--x-x-xx-x--xxxx--xsx-x-x-xx-xx-x-------x-xx-xx--x-xx-xx-x-------x-xx-xx--x-xx-xx-x-------x-xx-xx-x
x---x-x---x-x-xxxx--x-x----x-xx-xx-x-------x-xx-xx--x-xx-xx-x-------x-xx-xx--x-xx-xx-x-------x-xx-xx-x
xsxxx---x--x---xx-x-x---x--x-xx-xx-x-------x-xx-xx--x-xx-xx-x-------x-xx-xx--x-xx-xx-x-------x-xx-xx-x
x-x-x-xx-x-x-x----xxx-xx-x-x-xx-xx-x-------x-xx-xx--x-xx-xx-x-------x-xx-xx--x-xx-xx-x-------x-xx-xx-x
x------x------xxx------x--------x------xxx------x--------x------xxx------x--------x------xxx------x--x
x-x-x-x-x-xx-xxxx-x-x-x-x-------x------xxx------x--------x------xxx------x--------x------xxx------x--x
x-x-xx-xx-x-------x-xx-xx-------x------xxx------x--------x------xxx------x--------x------xxx------x--x
xxx--x-x-xx-x--xxxx--x-x-x------x------xxx------x--------x------xxx------x--------x------xxx------x--x
x---x-x---x-x-xxxx--x-x---------x------xxx------x--------x------xxx------x--------x------xxx------x--x
xx----------xxxxx----------xxx---x--x---xx-x-x---x--xxx---x--x---xx-x-x---x--xxx---x--x---xx-x-x---x-x
x-xxx---x--x---xx-x-x---x--xxx---x--x---xx-x-x---x--xxx---x--x---xx-x-x---x--xxx---x--x---xx-x-x---x-x
x------x------xxx------x---xxx---x--x---xx-x-x---x--xxx---x--x---xx-x-x---x--xxx---x--x---xx-x-x---x-x
x-xxx---x--x---xx-x-x---x--x-xx-xx-x-------x-xx-xx--x-xx-xx-x-------x-xx-xx--x-xx-xx-x-------x-xx-xx-x
x-x-x-xx-x-x-x----xxx-xx-x-x-xx-xx-x-------x-xx-xx--x-xx-xx-x-------x-xx-xx--x-xx-xx-x-------x-xx-xx-x
x------x------xxx------x--------x------xxx------x--------x------xxx------x--------x------xxx------x--x
x-x-x-x-x-xx-xxxx-x-x-x-x-------x------xxx------x--------x------xxx------x--------x------xxx------x--x
x-x-xx-xx-x-------x-xx-xx-------x------xxx------x--------x------xxx------x--------x------xxx------x--x
xxx--x-x-xx-x--xxxx--x-x-x------x------xxx------x--------x------xxx------x--------x------xxx------x--x
x---x-x---x-x-xxxx--x-x---------x------xxx------x--------x------xxx------x--------x------xxx------x--x
xx----------xxxxx----------xxx---x--x---xx-x-x---x--xxx---x--x------x-x---x--xxx---x--x---xx-x-x---x-x
x-xxx---x--x---xx-x-x---x--xxx---x--x---xx-x-x---x--xxx---x--x---xx-x-x---x--xxx---x--x---xx-x-x---x-x
x------x------xxx------x---xxx---x--x---xx-x-x---x--xxx---x--x---xx-xsx---x--xxx---x--x---xx-x-x---x-x
x-xxx---x--x---xx-x-x---x--x-xx-xx-x-------x-xx-xx--x-xx-xx-x-------x-xx-xx--x-xx-xx-x-------x-xx-xx-x
x-x-x-xx-x-x-x----xxx-xx-x-x-xx-xx-x-------x-xx-xx--x-xx-xx-x-------x-xx-xx--x-xx-xx-x-------x-xx-xx-x
x------x------xxx------x--------x------xxx---------------x------xxx------x---------------xxx------x--x
x-x-x-x-x-xx-xxxx-x-x-x-x-------x------xxx------x--------x------xxx------x--------x------xxx------x--x
x-x-xx-xx-x-------x-xx-xx-------x------xxx------x--------x------xxx------x--------x------xxx------x--x
xxx--x-x-xx-x--xxxx--x-x-x------x------xxx------x--------x---------------x--------x------xxx------x--x
x---x-x---x-x-xxxx--x-x---------x------xxx------x--------x------xxx------x--------x------xxx------x--x
xx----------xxxxx----------xxx------x---xx-x-x---x--xxx---x--x---xx-x-x---x--xxx---x--x---xx-x-x---x-x
x-xxx---x--x---xx-x-x---x--xxx---x--x---xx-x-x---x--xxx---x--x---xx-x-x---x--xxx---x--x---xx-x-x---x-x
x------x------xxx------x---xxx---x--x---xx-x-x---x--xxx---x--x---xx-x-x---x--xxx---x--x---xx-x-x---x-x
x-xxx---x--x---xx-x-x---x--x-xx-xx-x-------x-xx-xx--x-xx-xx-x-------x-xx-xx--x-xx-xx-x-------x-xx-xx-x
x-x-x-xx-x-x-x----xxx-xx-x-x-xx-xx-x-------x-xx-xx--x-xx-xx-x-------x-xx-xx--x-xx-xx-x-------x-xx-xx-x
x------x------xxx------x--------x------xxx------x--------x------xxx------x--------x------xxx------x--x
x-x-x-x-x-xx-xxxx-x-x-x-x-------x------xxx------x--------x------xxx---------------x------xxx------x--x
x-x-xx-xx-x-------x-xx-xx-------x------xxx------x--------x------xxx------x--------x------xxx------x--x
xxx--x-x-xx-x--xxxx--x-x-x------x------xxx------x--------x------xxx------x--------x------xxx------x--x
x---x-x---x-x-xxxx--x-x---------x------xxx------x--------x------xxx------x--------x------xxx------x--x
xx----------xxxxx----------xxx---x--x---xx-x-x---x--xxx------x---xx-x-x---x--xxx---x--x---xx-x-x---x-x
x-xxx---x--x---xx-x-x---x--xxx---x--x---xx-x-x---x--xxx---x--x---xx-x-x---x--xxx---x--x---xx-x-x---x-x
x------x------xxx------x---xxx---x--x---xx-x-x---x--xxx---x--x---xx-x-x---x--xxx---x--x---xx-x-x---x-x
x-xxx---x--x---xx-x-x---x--x-xx-xx-x-------x-xx-xx--x-xx-xx-x-------x-xx-xx--x-xx-xx-x-------x-xx-xx-x
x-x-x-xx-x-x-x----xxx-xx-x-x-xx-xx-x-------x-xx-xx--x-xx-xx-x-------x-xx-xx--x-xx-xx-x-------x-xx-xx-x
x------x------xxx------x--------x------xxx------x--------x------xxx---------------x------xxx---------x
x-x-x-x-x-xx-xxxx-x-x-x-x-------x------xxx------x--------x------xxx------x--------x------xxx------x--x
x-x-xx-xx-x-------x-xx-xx--------------xxx------x--------x------xxx------x--------x------xxx------x--x
xxx--x-x-xx-x--xxxx--x-x-x------x------xxx------x--------x------xxx------x--------x------xxx------x--x
x---x-x---x-x-xxxx--x-x---------x------xxx------x--------x------xxx------x---------------xxx------x--x
xx----------xxxxx----------xxx---x--x---xx-x-x------xxx---x--x---xx-x-x---x--xxx---x--x---xx-x-x---x-x
x-xxx---x--x---xx-x-x---x--xxx---x--x---xx-x-x---x--xxx---x--x---xx-x-x---x--xxx---x--x---xx-x-x---x-x
x------x------xxx------x---xxx---x--x---xx-x-x---x--xxx---x--x---xx-x-x---x--xxx---x--x---xx-x-x---x-x
x-xxx---x--x---xx-x-x---x--x-xx-xx-x-------x-xx-xx--x-xx-xx---------x-xx-xx--x-xx-xx-x-------x-xx-xx-x
x-x-x-xx-x-x-x----xxx-xx-x-x-xx-xx-x-------x-xx-xx--x-xx-xx-x-------x-xx-xx--x-xx-xx-x-------x-xx-xx-x
x------x------xxx------x---------------xxx------x--------x------xxx------x--------x------xxx---------x
x-x-x-x-x-xx-xxxx-x-x-x-x-------x------xxx------x--------x------xxx------x--------x------xxx------x--x
xsx-xx-xx-x-------x-xx-xx-------x------xxx------x--------x------xxx------x--------x------xxx------x--x
xxx--x-x-xx-x--xxxx--x-x-x------x------xxx------x--------x------xxx------x--------x------xxx------x-ex
xxxxxxxxxxxxxxxxxxxxxxxxxxxxxxxxxxxxxxxxxxxxxxxxxxxxxxxxxxxxxxxxxxxxxxxxxxxxxxxxxxxxxxxxxxxxxxxxxxxxxx